00000000000000000000000000000000000000000000000
00000000000000000000000000000000000000000000000
00000000000000000000000000000000000000000000000
00000000000000000000000000000000000000000000000
00000000000000000000000000000000000000000000000
01111000000000000000000000000000000000001111100
01111000000000000000000000000000000000001111100
01111000000000000000000000000000000000001111100
01111000000000000000000000000111100000001111100
01111000000000000000000000000000000000001111100
01111000000000000000000000000000000000001111100
01111000000000000000000000000000000000001111100
11111111111111111111111111111111111111111111111
11111111111111111111111111111111111111111111111