000000000000000000000000000000000000000000000000
000000000000000000000000000000000000000000000000
000000000000000000000000000000000000000000000000
000000000000000000000000000000000000000000000000
000000000000000000000000000000000000000000000000
005776000000000000000000000000000000000005777600
003112000000000000000000000000577600000003111200
003112000000000000000000000000311200000003111200
003112000000000000000000000000000000000003111200
003112000000000000000000000000005600000003111200
003112000000000000000000000000051200000003111200
771111777777600000000000000000577777777771111177
111111111111177777777777777777111111111111111111
111111111111111111111111111111111111111111111111
111111111111111111111111111111111111111111111111
111111111111111111111111111111111111111111111111
111111111111111111111111111111111111111111111111
111111111111111111111111111111111111111111111111
111111111111111111111111111111111111111111111111
111111111111111111111111111111111111111111111111
111111111111111111111111111111111111111111111111